############################
#            ##            #
# #### ##### ## ##### #### #
# #  # #   # ## #   # #  # #
# #### ##### ## ##### #### #
#                          #
# #### ## ######## ## #### #
# #### ## ######## ## #### #
#      ##    ##    ##      #
###### ##### ## ##### ######
     # ##### ## ##### #     
     # ##          ## #     
     # ## ######## ## #     
###### ## #      # ## ######
          #      #          
###### ## #      # ## ######
     # ## ######## ## #     
     # ##          ## #     
     # ## ######## ## #     
###### ## ######## ## ######
#            ##            #
# #### ##### ## ##### #### #
# #### ##### ## ##### #### #
#   ##                ##   #
### ## ## ######## ## ## ###
### ## ## ######## ## ## ###
#      ##    ##    ##      #
# ########## ## ########## #
# ########## ## ########## #
#                          #
############################