###################
#                 #
#  #              #
#   #             #
#    #            #
#     #           #
#      #          #
#       #         #
#        #        #
#         #       #
#          #      #
#           #     #
#            #    #
#             #   #
#              #  #
#                 #
###################
